전국|전국
수도권|수도권
지방권|지방권
6대광역시|6대광역시
5대광역시|5대광역시
9개도|9개도
8개도|8개도
서울|서울
서울강북지역|강북지역
서울도심권|도심권
서울종로구|종로구
서울중구|중구
서울용산구|용산구
서울동북권|동북권
서울성동구|성동구
서울광진구|광진구
서울동대문구|동대문구
서울중랑구|중랑구
서울성북구|성북구
서울강북구|강북구
서울도봉구|도봉구
서울노원구|노원구
서울서북권|서북권
서울은평구|은평구
서울서대문구|서대문구
서울마포구|마포구
서울강남지역|강남지역
서울서남권|서남권
서울양천구|양천구
서울강서구|강서구
서울구로구|구로구
서울금천구|금천구
서울영등포구|영등포구
서울동작구|동작구
서울관악구|관악구
서울동남권|동남권
서울서초구|서초구
서울강남구|강남구
서울송파구|송파구
서울강동구|강동구
경기|경기
경기경부1권|경부1권
경기과천시|과천시
경기안양시|안양시
경기만안구|만안구
경기동안구|동안구
경기성남시|성남시
경기수정구|수정구
경기중원구|중원구
경기분당구|분당구
경기군포시|군포시
경기의왕시|의왕시
경기경부2권|경부2권
경기안성시|안성시
경기용인시|용인시
경기처인구|처인구
경기기흥구|기흥구
경기수지구|수지구
경기수원시|수원시
경기장안구|장안구
경기권선구|권선구
경기팔달구|팔달구
경기영통구|영통구
경기서해안권|서해안권
경기부천시|부천시
경기안산시|안산시
경기상록구|상록구
경기단원구|단원구
경기시흥시|시흥시
경기광명시|광명시
경기화성시|화성시
경기오산시|오산시
경기평택시|평택시
경기동부1권|동부1권
경기남양주시|남양주시
경기구리시|구리시
경기하남시|하남시
경기광주시|광주시
경기동부2권|동부2권
경기이천시|이천시
경기여주시|여주시
경기경의권|경의권
경기김포시|김포시
경기고양시|고양시
경기덕양구|덕양구
경기일산동구|일산동구
경기일산서구|일산서구
경기파주시|파주시
경기경원권|경원권
경기포천시|포천시
경기동두천시|동두천시
경기양주시|양주시
경기의정부시|의정부시
인천|인천
인천중구|중구
인천동구|동구
인천미추홀구|미추홀구
인천연수구|연수구
인천남동구|남동구
인천부평구|부평구
인천계양구|계양구
인천서구|서구
부산|부산
부산중부산권|중부산권
부산중구|중구
부산서구|서구
부산동구|동구
부산영도구|영도구
부산부산진구|부산진구
부산남구|남구
부산연제구|연제구
부산수영구|수영구
부산동부산권|동부산권
부산해운대구|해운대구
부산금정구|금정구
부산동래구|동래구
부산기장군|기장군
부산서부산권|서부산권
부산북구|북구
부산강서구|강서구
부산사상구|사상구
부산사하구|사하구
대구|대구
대구중구|중구
대구동구|동구
대구서구|서구
대구남구|남구
대구북구|북구
대구수성구|수성구
대구달서구|달서구
대구달성군|달성군
광주|광주
광주동구|동구
광주서구|서구
광주남구|남구
광주북구|북구
광주광산구|광산구
대전|대전
대전동구|동구
대전중구|중구
대전서구|서구
대전유성구|유성구
대전대덕구|대덕구
울산|울산
울산중구|중구
울산남구|남구
울산동구|동구
울산북구|북구
울산울주군|울주군
세종|세종
강원|강원
강원춘천시|춘천시
강원원주시|원주시
강원강릉시|강릉시
강원동해시|동해시
강원태백시|태백시
강원속초시|속초시
강원삼척시|삼척시
충북|충북
충북청주시|청주시
충북상당구|상당구
충북서원구|서원구
충북흥덕구|흥덕구
충북청원구|청원구
충북충주시|충주시
충북제천시|제천시
충북음성군|음성군
충남|충남
충남천안시|천안시
충남동남구|동남구
충남서북구|서북구
충남공주시|공주시
충남보령시|보령시
충남아산시|아산시
충남서산시|서산시
충남논산시|논산시
충남계룡시|계룡시
충남홍성군|홍성군
충남예산군|예산군
충남당진시|당진시
전북|전북
전북전주시|전주시
전북완산구|완산구
전북덕진구|덕진구
전북군산시|군산시
전북익산시|익산시
전북정읍시|정읍시
전북남원시|남원시
전북김제시|김제시
전남|전남
전남목포시|목포시
전남여수시|여수시
전남순천시|순천시
전남나주시|나주시
전남광양시|광양시
전남무안군|무안군
경북|경북
경북포항시|포항시
경북남구|남구
경북북구|북구
경북경주시|경주시
경북김천시|김천시
경북안동시|안동시
경북구미시|구미시
경북영주시|영주시
경북영천시|영천시
경북상주시|상주시
경북문경시|문경시
경북경산시|경산시
경북칠곡군|칠곡군
경남|경남
경남창원시|창원시
경남의창구|의창구
경남성산구|성산구
경남마산합포구|마산합포구
경남마산회원구|마산회원구
경남진해구|진해구
경남진주시|진주시
경남통영시|통영시
경남사천시|사천시
경남김해시|김해시
경남밀양시|밀양시
경남거제시|거제시
경남양산시|양산시
제주|제주
제주제주시|제주시
제주서귀포시|서귀포시
